AA	aa (ndm)
AALBORSCY	aalborski
AALBORSKA	aalborski
AALBORSKI	aalborski
AALBORSKICH	aalborski
AALBORSKIE	aalborski
AALBORSKIEGO	aalborski
AALBORSKIEJ	aalborski
AALBORSKIEMU	aalborski
AALBORSKIM	aalborski
AALBORSKIMI	aalborski
AALBORSKO	aalborsko
AALBORSKU	aalborski
AALBORSKĄ	aalborski
ABACE	abaka
ABACI	abat
ABACIE	abat
ABADANCE	abadanka
ABADANEK	abadanka
ABADANKA	abadanka
ABADANKACH	abadanka
ABADANKAMI	abadanka
ABADANKI	abadanka
ABADANKO	abadanka
ABADANKOM	abadanka
ABADANKĄ	abadanka
ABADANKĘ	abadanka
ABADAŃCZYCY	abadańczyk
ABADAŃCZYK	abadańczyk
ABADAŃCZYKA	abadańczyk
ABADAŃCZYKACH	abadańczyk
ABADAŃCZYKAMI	abadańczyk
ABADAŃCZYKI	abadańczyk
ABADAŃCZYKIEM	abadańczyk
ABADAŃCZYKOM	abadańczyk
ABADAŃCZYKOWI	abadańczyk
ABADAŃCZYKU	abadańczyk
ABADAŃCZYKÓW	abadańczyk
ABADAŃSCY	abadański
ABADAŃSKA	abadański
ABADAŃSKI	abadański
ABADAŃSKICH	abadański
ABADAŃSKIE	abadański
ABADAŃSKIEGO	abadański
ABADAŃSKIEJ	abadański
ABADAŃSKIEMU	abadański
ABADAŃSKIM	abadański
ABADAŃSKIMI	abadański
ABADAŃSKO	abadańsko
ABADAŃSKU	abadański
ABADAŃSKĄ	abadański
ABAI	abaja
ABAJ	abaja
ABAJA	abaja
ABAJACH	abaja
ABAJAMI	abaja
ABAJE	abaja
ABAJO	abaja
ABAJOM	abaja
ABAJĄ	abaja
ABAJĘ	abaja
ABAK	abak
ABAK	abaka
ABAKA	abaka
ABAKACH	abak
ABAKACH	abaka
ABAKAMI	abak
ABAKAMI	abaka
ABAKAN	abakan
ABAKANACH	abakan
ABAKANAMI	abakan
ABAKANCE	abakanka
ABAKANEK	abakanka
ABAKANEM	abakan
ABAKANIE	abakan
ABAKANKA	abakanka
ABAKANKACH	abakanka
ABAKANKAMI	abakanka
ABAKANKI	abakanka
ABAKANKO	abakanka
ABAKANKOM	abakanka
ABAKANKĄ	abakanka
ABAKANKĘ	abakanka
ABAKANOM	abakan
ABAKANOWI	abakan
ABAKANU	abakan
ABAKANY	abakan
ABAKANÓW	abakan
ABAKAŃCZYCY	abakańczyk
ABAKAŃCZYK	abakańczyk
ABAKAŃCZYKA	abakańczyk
ABAKAŃCZYKACH	abakańczyk
ABAKAŃCZYKAMI	abakańczyk
ABAKAŃCZYKI	abakańczyk
ABAKAŃCZYKIEM	abakańczyk
ABAKAŃCZYKOM	abakańczyk
ABAKAŃCZYKOWI	abakańczyk
ABAKAŃCZYKU	abakańczyk
ABAKAŃCZYKÓW	abakańczyk
ABAKAŃSCY	abakański
ABAKAŃSKA	abakański
ABAKAŃSKI	abakański
ABAKAŃSKICH	abakański
ABAKAŃSKIE	abakański
ABAKAŃSKIEGO	abakański
ABAKAŃSKIEJ	abakański
ABAKAŃSKIEMU	abakański
ABAKAŃSKIM	abakański
ABAKAŃSKIMI	abakański
ABAKAŃSKO	abakańsko
ABAKAŃSKU	abakański
ABAKAŃSKĄ	abakański
ABAKI	abak
ABAKI	abaka
ABAKIEM	abak
ABAKO	abaka
ABAKOM	abak
ABAKOM	abaka
ABAKOWI	abak
ABAKU	abak
ABAKUS	abakus
ABAKUSA	abakus
ABAKUSACH	abakus
ABAKUSAMI	abakus
ABAKUSEM	abakus
ABAKUSIE	abakus
ABAKUSOM	abakus
ABAKUSOWI	abakus
ABAKUSY	abakus
ABAKUSÓW	abakus
ABAKĄ	abaka
ABAKĘ	abaka
ABAKÓW	abak
ABALIETAS	abalietas (ndm)
ABANDON	abandon
ABANDONACH	abandon
ABANDONAMI	abandon
ABANDONEM	abandon
ABANDONIE	abandon
ABANDONOM	abandon
ABANDONOWI	abandon
ABANDONU	abandon
ABANDONY	abandon
ABANDONÓW	abandon
ABAT	abat
ABATA	abat
ABATACH	abat
ABATAMI	abat
ABATEM	abat
ABATOM	abat
ABATOWI	abat
ABATY	abat
ABATYS	abatysa
ABATYSA	abatysa
ABATYSACH	abatysa
ABATYSAMI	abatysa
ABATYSIE	abatysa
ABATYSO	abatysa
ABATYSOM	abatysa
ABATYSY	abatysa
ABATYSĄ	abatysa
ABATYSĘ	abatysa
ABATÓW	abat
ABAZJA	abazja
ABAZJACH	abazja
ABAZJAMI	abazja
ABAZJE	abazja
ABAZJI	abazja
ABAZJO	abazja
ABAZJOM	abazja
ABAZJĄ	abazja
ABAZJĘ	abazja
ABAZYJ	abazja
ABAZYŃSCY	abazyński
ABAZYŃSKA	abazyński
ABAZYŃSKI	abazyński
ABAZYŃSKICH	abazyński
ABAZYŃSKIE	abazyński
ABAZYŃSKIEGO	abazyński
ABAZYŃSKIEJ	abazyński
ABAZYŃSKIEMU	abazyński
ABAZYŃSKIM	abazyński
ABAZYŃSKIMI	abazyński
ABAZYŃSKO	abazyńsko
ABAZYŃSKU	abazyński
ABAZYŃSKĄ	abazyński
ABAŻUR	abażur
ABAŻURA	abażur
ABAŻURACH	abażur
ABAŻURAMI	abażur
ABAŻUREK	abażurek
ABAŻUREM	abażur
ABAŻURKA	abażurek
ABAŻURKACH	abażurek
ABAŻURKAMI	abażurek
ABAŻURKI	abażurek
ABAŻURKIEM	abażurek
ABAŻURKOM	abażurek
ABAŻURKOWI	abażurek
ABAŻURKU	abażurek
ABAŻURKÓW	abażurek
ABAŻUROM	abażur
ABAŻUROWA	abażurowy
ABAŻUROWE	abażurowy
ABAŻUROWEGO	abażurowy
ABAŻUROWEJ	abażurowy
ABAŻUROWEMU	abażurowy
ABAŻUROWI	abażur
ABAŻUROWI	abażurowy
ABAŻUROWY	abażurowy
ABAŻUROWYCH	abażurowy
ABAŻUROWYM	abażurowy
ABAŻUROWYMI	abażurowy
ABAŻUROWĄ	abażurowy
ABAŻURU	abażur
ABAŻURY	abażur
ABAŻURZE	abażur
ABAŻURÓW	abażur
ABBA	abba
ABBACH	abba
ABBAMI	abba
ABBIE	abba
ABBO	abba
ABBOM	abba
ABBOWIE	abba
ABBY	abba
ABBĄ	abba
ABBĘ	abba
ABBÓW	abba
ABCHASCY	abchaski
ABCHASKA	abchaski
ABCHASKI	abchaski
ABCHASKICH	abchaski
ABCHASKIE	abchaski
ABCHASKIEGO	abchaski
ABCHASKIEJ	abchaski
ABCHASKIEMU	abchaski
ABCHASKIM	abchaski
ABCHASKIMI	abchaski
ABCHASKO	abchasko
ABCHASKU	abchaski
ABCHASKĄ	abchaski
ABCUG	abcug
ABCUGACH	abcug
ABCUGAMI	abcug
ABCUGI	abcug
ABCUGIEM	abcug
ABCUGOM	abcug
ABCUGOWI	abcug
ABCUGU	abcug
ABCUGÓW	abcug
ABDERYCCY	abderycki
ABDERYCI	abderyta
ABDERYCIE	abderyta
ABDERYCKA	abderycki
ABDERYCKI	abderycki
ABDERYCKICH	abderycki
ABDERYCKIE	abderycki
ABDERYCKIEGO	abderycki
ABDERYCKIEJ	abderycki
ABDERYCKIEMU	abderycki
ABDERYCKIM	abderycki
ABDERYCKIMI	abderycki
ABDERYCKO	abderycko
ABDERYCKU	abderycki
ABDERYCKĄ	abderycki
ABDERYTA	abderyta
ABDERYTACH	abderyta
ABDERYTAMI	abderyta
ABDERYTCE	abderytka
ABDERYTEK	abderytka
ABDERYTKA	abderytka
ABDERYTKACH	abderytka
ABDERYTKAMI	abderytka
ABDERYTKI	abderytka
ABDERYTKO	abderytka
ABDERYTKOM	abderytka
ABDERYTKĄ	abderytka
ABDERYTKĘ	abderytka
ABDERYTO	abderyta
ABDERYTOM	abderyta
ABDERYTY	abderyta
ABDERYTĄ	abderyta
ABDERYTĘ	abderyta
ABDERYTÓW	abderyta
ABDOMEN	abdomen
ABDOMENACH	abdomen
ABDOMENAMI	abdomen
ABDOMENEM	abdomen
ABDOMENIE	abdomen
ABDOMENOM	abdomen
ABDOMENOWI	abdomen
ABDOMENU	abdomen
ABDOMENY	abdomen
ABDOMENÓW	abdomen
ABDOMINALNA	abdominalny
ABDOMINALNE	abdominalny
ABDOMINALNEGO	abdominalny
ABDOMINALNEJ	abdominalny
ABDOMINALNEMU	abdominalny
ABDOMINALNI	abdominalny
ABDOMINALNY	abdominalny
ABDOMINALNYCH	abdominalny
ABDOMINALNYM	abdominalny
ABDOMINALNYMI	abdominalny
ABDOMINALNĄ	abdominalny
ABDOMINOPLASTYK	abdominoplastyka
ABDUKCJA	abdukcja
ABDUKCJACH	abdukcja
ABDUKCJAMI	abdukcja
ABDUKCJE	abdukcja
ABDUKCJI	abdukcja
ABDUKCJO	abdukcja
ABDUKCJOM	abdukcja
ABDUKCJĄ	abdukcja
ABDUKCJĘ	abdukcja
ABDUKCYJ	abdukcja
ABDUKTOR	abduktor
ABDUKTORA	abduktor
ABDUKTORACH	abduktor
ABDUKTORAMI	abduktor
ABDUKTOREM	abduktor
ABDUKTOROM	abduktor
ABDUKTOROWI	abduktor
ABDUKTORY	abduktor
ABDUKTORZE	abduktor
ABDUKTORÓW	abduktor
ABDYKACJA	abdykacja
ABDYKACJACH	abdykacja
ABDYKACJAMI	abdykacja
ABDYKACJE	abdykacja
ABDYKACJI	abdykacja
ABDYKACJO	abdykacja
ABDYKACJOM	abdykacja
ABDYKACJĄ	abdykacja
ABDYKACJĘ	abdykacja
ABDYKACYJ	abdykacja
ABDYKACYJNA	abdykacyjny
ABDYKACYJNE	abdykacyjny
ABDYKACYJNEGO	abdykacyjny
ABDYKACYJNEJ	abdykacyjny
ABDYKACYJNEMU	abdykacyjny
ABDYKACYJNI	abdykacyjny
ABDYKACYJNY	abdykacyjny
ABDYKACYJNYCH	abdykacyjny
ABDYKACYJNYM	abdykacyjny
ABDYKACYJNYMI	abdykacyjny
ABDYKACYJNĄ	abdykacyjny
ABDYKOWALI	abdykować
ABDYKOWALIBY	abdykować
ABDYKOWALIBYŚMY	abdykować
ABDYKOWALIŚCIE	abdykować
ABDYKOWALIŚMY	abdykować
ABDYKOWANIA	abdykowanie
ABDYKOWANIA	abdykować
ABDYKOWANIACH	abdykowanie
ABDYKOWANIACH	abdykować
ABDYKOWANIAMI	abdykowanie
ABDYKOWANIAMI	abdykować
ABDYKOWANIE	abdykowanie
ABDYKOWANIE	abdykować
ABDYKOWANIEM	abdykowanie
ABDYKOWANIEM	abdykować
ABDYKOWANIOM	abdykowanie
ABDYKOWANIOM	abdykować
ABDYKOWANIU	abdykowanie
ABDYKOWANIU	abdykować
ABDYKOWANO	abdykować
ABDYKOWAWSZY	abdykować
ABDYKOWAŁ	abdykować
ABDYKOWAŁA	abdykować
ABDYKOWAŁABY	abdykować
ABDYKOWAŁABYM	abdykować
ABDYKOWAŁABYŚ	abdykować
ABDYKOWAŁAM	abdykować
ABDYKOWAŁAŚ	abdykować
ABDYKOWAŁBY	abdykować
ABDYKOWAŁBYM	abdykować
ABDYKOWAŁBYŚ	abdykować
ABDYKOWAŁEM	abdykować
ABDYKOWAŁEŚ	abdykować
ABDYKOWAŁO	abdykować
ABDYKOWAŁOBY	abdykować
ABDYKOWAŁOBYM	abdykować
ABDYKOWAŁOBYŚ	abdykować
ABDYKOWAŁOM	abdykować
ABDYKOWAŁOŚ	abdykować
ABDYKOWAŁY	abdykować
ABDYKOWAŁYBY	abdykować
ABDYKOWAŁYBYŚMY	abdykować
ABDYKOWAŁYŚCIE	abdykować
ABDYKOWAŁYŚMY	abdykować
ABDYKOWAĆ	abdykować
ABDYKOWAŃ	abdykowanie
ABDYKOWAŃ	abdykować
ABDYKUJ	abdykować
ABDYKUJCIE	abdykować
ABDYKUJCIEŻ	abdykować
ABDYKUJE	abdykować
ABDYKUJECIE	abdykować
ABDYKUJEMY	abdykować
ABDYKUJESZ	abdykować
ABDYKUJMY	abdykować
ABDYKUJMYŻ	abdykować
ABDYKUJĄ	abdykować
ABDYKUJĄC	abdykować
ABDYKUJĄCA	abdykować
ABDYKUJĄCE	abdykować
ABDYKUJĄCEGO	abdykować
ABDYKUJĄCEJ	abdykować
ABDYKUJĄCEMU	abdykować
ABDYKUJĄCY	abdykować
ABDYKUJĄCYCH	abdykować
ABDYKUJĄCYM	abdykować
ABDYKUJĄCYMI	abdykować
ABDYKUJĄCĄ	abdykować
ABDYKUJŻE	abdykować
ABDYKUJĘ	abdykować
ABECADEŁ	abecadło
ABECADLE	abecadło
ABECADŁA	abecadło
ABECADŁACH	abecadło
ABECADŁAMI	abecadło
ABECADŁEM	abecadło
ABECADŁO	abecadło
ABECADŁOM	abecadło
ABECADŁOWA	abecadłowy
ABECADŁOWE	abecadłowy
ABECADŁOWEGO	abecadłowy
ABECADŁOWEJ	abecadłowy
ABECADŁOWEMU	abecadłowy
ABECADŁOWI	abecadłowy
ABECADŁOWO	abecadłowo
ABECADŁOWY	abecadłowy
ABECADŁOWYCH	abecadłowy
ABECADŁOWYM	abecadłowy
ABECADŁOWYMI	abecadłowy
ABECADŁOWĄ	abecadłowy
ABECADŁU	abecadło
ABECEDARIUSZ	abecedariusz
ABECEDARIUSZA	abecedariusz
ABECEDARIUSZACH	abecedariusz
ABECEDARIUSZAMI	abecedariusz
ABECEDARIUSZE	abecedariusz
ABECEDARIUSZEM	abecedariusz
ABECEDARIUSZOM	abecedariusz
ABECEDARIUSZOWI	abecedariusz
ABECEDARIUSZU	abecedariusz
ABECEDARIUSZY	abecedariusz
ABELICIE	abelit
ABELIT	abelit
ABELITACH	abelit
ABELITAMI	abelit
ABELITEM	abelit
ABELITOM	abelit
ABELITOWI	abelit
ABELITU	abelit
ABELITY	abelit
ABELITÓW	abelit
ABELOWA	abelowy
ABELOWE	abelowy
ABELOWEGO	abelowy
ABELOWEJ	abelowy
ABELOWEMU	abelowy
ABELOWI	abelowy
ABELOWY	abelowy
ABELOWYCH	abelowy
ABELOWYM	abelowy
ABELOWYMI	abelowy
ABELOWĄ	abelowy
ABERRACJA	aberracja
ABERRACJACH	aberracja
ABERRACJAMI	aberracja
ABERRACJE	aberracja
ABERRACJI	aberracja
ABERRACJO	aberracja
ABERRACJOM	aberracja
ABERRACJĄ	aberracja
ABERRACJĘ	aberracja
ABERRACYJ	aberracja
ABERRACYJNA	aberracyjny
ABERRACYJNE	aberracyjny
ABERRACYJNEGO	aberracyjny
ABERRACYJNEJ	aberracyjny
ABERRACYJNEMU	aberracyjny
ABERRACYJNI	aberracyjny
ABERRACYJNY	aberracyjny
ABERRACYJNYCH	aberracyjny
ABERRACYJNYM	aberracyjny
ABERRACYJNYMI	aberracyjny
ABERRACYJNĄ	aberracyjny
ABERROSKOP	aberroskop
ABERROSKOPACH	aberroskop
ABERROSKOPAMI	aberroskop
ABERROSKOPEM	aberroskop
ABERROSKOPIE	aberroskop
ABERROSKOPOM	aberroskop
ABERROSKOPOWI	aberroskop
ABERROSKOPU	aberroskop
ABERROSKOPY	aberroskop
ABERROSKOPÓW	aberroskop
ABIDŻANCE	abidżanka
ABIDŻANEK	abidżanka
ABIDŻANKA	abidżanka
ABIDŻANKACH	abidżanka
ABIDŻANKAMI	abidżanka
ABIDŻANKI	abidżanka
ABIDŻANKO	abidżanka
ABIDŻANKOM	abidżanka
ABIDŻANKĄ	abidżanka
ABIDŻANKĘ	abidżanka
ABIDŻAŃCZYCY	abidżańczyk
ABIDŻAŃCZYK	abidżańczyk
ABIDŻAŃCZYKA	abidżańczyk
ABIDŻAŃCZYKACH	abidżańczyk
ABIDŻAŃCZYKAMI	abidżańczyk
ABIDŻAŃCZYKI	abidżańczyk
ABIDŻAŃCZYKIEM	abidżańczyk
ABIDŻAŃCZYKOM	abidżańczyk
ABIDŻAŃCZYKOWI	abidżańczyk
ABIDŻAŃCZYKU	abidżańczyk
ABIDŻAŃCZYKÓW	abidżańczyk
ABIDŻAŃSCY	abidżański
ABIDŻAŃSKA	abidżański
ABIDŻAŃSKI	abidżański
ABIDŻAŃSKICH	abidżański
ABIDŻAŃSKIE	abidżański
ABIDŻAŃSKIEGO	abidżański
ABIDŻAŃSKIEJ	abidżański
ABIDŻAŃSKIEMU	abidżański
ABIDŻAŃSKIM	abidżański
ABIDŻAŃSKIMI	abidżański
ABIDŻAŃSKO	abidżańsko
ABIDŻAŃSKU	abidżański
ABIDŻAŃSKĄ	abidżański
ABIETYN	abietyna
ABIETYNA	abietyna
ABIETYNACH	abietyna
ABIETYNAMI	abietyna
ABIETYNIE	abietyna
ABIETYNO	abietyna
ABIETYNOM	abietyna
ABIETYNOWA	abietynowy
ABIETYNOWE	abietynowy
ABIETYNOWEGO	abietynowy
ABIETYNOWEJ	abietynowy
ABIETYNOWEMU	abietynowy
ABIETYNOWI	abietynowy
ABIETYNOWY	abietynowy
ABIETYNOWYCH	abietynowy
ABIETYNOWYM	abietynowy
ABIETYNOWYMI	abietynowy
ABIETYNOWĄ	abietynowy
ABIETYNY	abietyna
ABIETYNĄ	abietyna
ABIETYNĘ	abietyna
ABIOGENEZ	abiogeneza
ABIOGENEZA	abiogeneza
ABIOGENEZACH	abiogeneza
ABIOGENEZAMI	abiogeneza
ABIOGENEZIE	abiogeneza
ABIOGENEZO	abiogeneza
ABIOGENEZOM	abiogeneza
ABIOGENEZY	abiogeneza
ABIOGENEZĄ	abiogeneza
ABIOGENEZĘ	abiogeneza
ABIOGENNA	abiogenny
ABIOGENNE	abiogenny
ABIOGENNEGO	abiogenny
ABIOGENNEJ	abiogenny
ABIOGENNEMU	abiogenny
ABIOGENNI	abiogenny
ABIOGENNY	abiogenny
ABIOGENNYCH	abiogenny
ABIOGENNYM	abiogenny
ABIOGENNYMI	abiogenny
ABIOGENNĄ	abiogenny
ABIOLOGIA	abiologia
ABIOLOGIACH	abiologia
ABIOLOGIAMI	abiologia
ABIOLOGICZNA	abiologiczny
ABIOLOGICZNE	abiologiczny
ABIOLOGICZNEGO	abiologiczny
ABIOLOGICZNEJ	abiologiczny
ABIOLOGICZNEMU	abiologiczny
ABIOLOGICZNI	abiologiczny
ABIOLOGICZNY	abiologiczny
ABIOLOGICZNYCH	abiologiczny
ABIOLOGICZNYM	abiologiczny
ABIOLOGICZNYMI	abiologiczny
ABIOLOGICZNĄ	abiologiczny
ABIOLOGIE	abiologia
ABIOLOGII	abiologia
ABIOLOGIJ	abiologia
ABIOLOGIO	abiologia
ABIOLOGIOM	abiologia
ABIOLOGIĄ	abiologia
ABIOLOGIĘ	abiologia
ABIOTYCZNA	abiotyczny
ABIOTYCZNE	abiotyczny
ABIOTYCZNEGO	abiotyczny
ABIOTYCZNEJ	abiotyczny
ABIOTYCZNEMU	abiotyczny
ABIOTYCZNI	abiotyczny
ABIOTYCZNY	abiotyczny
ABIOTYCZNYCH	abiotyczny
ABIOTYCZNYM	abiotyczny
ABIOTYCZNYMI	abiotyczny
ABIOTYCZNĄ	abiotyczny
ABISAL	abisal
ABISALACH	abisal
ABISALAMI	abisal
ABISALE	abisal
ABISALEM	abisal
ABISALI	abisal
ABISALNA	abisalny
ABISALNE	abisalny
ABISALNEGO	abisalny
ABISALNEJ	abisalny
ABISALNEMU	abisalny
ABISALNI	abisalny
ABISALNY	abisalny
ABISALNYCH	abisalny
ABISALNYM	abisalny
ABISALNYMI	abisalny
ABISALNĄ	abisalny
ABISALOM	abisal
ABISALOWI	abisal
ABISALU	abisal
ABISALÓW	abisal
ABISOBIONCIE	abisobiont
ABISOBIONT	abisobiont
ABISOBIONTA	abisobiont
ABISOBIONTACH	abisobiont
ABISOBIONTAMI	abisobiont
ABISOBIONTEM	abisobiont
ABISOBIONTOM	abisobiont
ABISOBIONTOWI	abisobiont
ABISOBIONTY	abisobiont
ABISOBIONTÓW	abisobiont
ABISOFIL	abisofil
ABISOFILA	abisofil
ABISOFILACH	abisofil
ABISOFILAMI	abisofil
ABISOFILE	abisofil
ABISOFILEM	abisofil
ABISOFILI	abisofil
ABISOFILOM	abisofil
ABISOFILOWI	abisofil
ABISOFILU	abisofil
ABISOFILÓW	abisofil
ABISYNCE	abisynka
ABISYNEK	abisynka
ABISYNKA	abisynka
ABISYNKACH	abisynka
ABISYNKAMI	abisynka
ABISYNKI	abisynka
ABISYNKO	abisynka
ABISYNKOM	abisynka
ABISYNKĄ	abisynka
ABISYNKĘ	abisynka
ABISYŃSCY	abisyński
ABISYŃSKA	abisyński
ABISYŃSKI	abisyński
ABISYŃSKICH	abisyński
ABISYŃSKIE	abisyński
ABISYŃSKIEGO	abisyński
ABISYŃSKIEJ	abisyński
ABISYŃSKIEMU	abisyński
ABISYŃSKIM	abisyński
ABISYŃSKIMI	abisyński
ABISYŃSKO	abisyńsko
ABISYŃSKU	abisyński
ABISYŃSKĄ	abisyński
ABITELL	abitella
ABITELLA	abitella
ABITELLACH	abitella
ABITELLAMI	abitella
ABITELLE	abitella
ABITELLI	abitella
ABITELLO	abitella
ABITELLOM	abitella
ABITELLĄ	abitella
ABITELLĘ	abitella
ABITURIENCI	abiturient
ABITURIENCIE	abiturient
ABITURIENT	abiturient
ABITURIENTA	abiturient
ABITURIENTACH	abiturient
ABITURIENTAMI	abiturient
ABITURIENTCE	abiturientka
ABITURIENTEK	abiturientka
ABITURIENTEM	abiturient
ABITURIENTKA	abiturientka
ABITURIENTKACH	abiturientka
ABITURIENTKAMI	abiturientka
ABITURIENTKI	abiturientka
ABITURIENTKO	abiturientka
ABITURIENTKOM	abiturientka
ABITURIENTKĄ	abiturientka
ABITURIENTKĘ	abiturientka
ABITURIENTOM	abiturient
ABITURIENTOWI	abiturient
ABITURIENTY	abiturient
ABITURIENTÓW	abiturient
ABITURYN	abituryna
ABITURYNA	abituryna
ABITURYNACH	abituryna
ABITURYNAMI	abituryna
ABITURYNIE	abituryna
ABITURYNO	abituryna
ABITURYNOM	abituryna
ABITURYNY	abituryna
ABITURYNĄ	abituryna
ABITURYNĘ	abituryna
ABIUDYKACJA	abiudykacja
ABIUDYKACJACH	abiudykacja
ABIUDYKACJAMI	abiudykacja
ABIUDYKACJE	abiudykacja
ABIUDYKACJI	abiudykacja
ABIUDYKACJO	abiudykacja
ABIUDYKACJOM	abiudykacja
ABIUDYKACJĄ	abiudykacja
ABIUDYKACJĘ	abiudykacja
ABIUDYKACYJ	abiudykacja
ABIURACJA	abiuracja
ABIURACJACH	abiuracja
ABIURACJAMI	abiuracja
ABIURACJE	abiuracja
ABIURACJI	abiuracja
ABIURACJO	abiuracja
ABIURACJOM	abiuracja
ABIURACJĄ	abiuracja
ABIURACJĘ	abiuracja
ABIURACYJ	abiuracja
ABLACJA	ablacja
ABLACJACH	ablacja
ABLACJAMI	ablacja
ABLACJE	ablacja
ABLACJI	ablacja
ABLACJO	ablacja
ABLACJOM	ablacja
ABLACJĄ	ablacja
ABLACJĘ	ablacja
ABLACYJ	ablacja
ABLACYJNA	ablacyjny
ABLACYJNE	ablacyjny
ABLACYJNEGO	ablacyjny
ABLACYJNEJ	ablacyjny
ABLACYJNEMU	ablacyjny
ABLACYJNI	ablacyjny
ABLACYJNY	ablacyjny
ABLACYJNYCH	ablacyjny
ABLACYJNYM	ablacyjny
ABLACYJNYMI	ablacyjny
ABLACYJNĄ	ablacyjny
ABLAKTACJA	ablaktacja
ABLAKTACJACH	ablaktacja
ABLAKTACJAMI	ablaktacja
ABLAKTACJE	ablaktacja
ABLAKTACJI	ablaktacja
ABLAKTACJO	ablaktacja
ABLAKTACJOM	ablaktacja
ABLAKTACJĄ	ablaktacja
ABLAKTACJĘ	ablaktacja
ABLAKTACYJ	ablaktacja
ABLAKTOWALI	ablaktować
ABLAKTOWALIBY	ablaktować
ABLAKTOWALIŚCIE	ablaktować
ABLAKTOWALIŚMY	ablaktować
ABLAKTOWANA	ablaktować
ABLAKTOWANE	ablaktować
ABLAKTOWANEGO	ablaktować
ABLAKTOWANEJ	ablaktować
ABLAKTOWANEMU	ablaktować
ABLAKTOWANI	ablaktować
ABLAKTOWANIA	ablaktowanie
ABLAKTOWANIA	ablaktować
ABLAKTOWANIACH	ablaktowanie
ABLAKTOWANIACH	ablaktować
ABLAKTOWANIAMI	ablaktowanie
ABLAKTOWANIAMI	ablaktować
ABLAKTOWANIE	ablaktowanie
ABLAKTOWANIE	ablaktować
ABLAKTOWANIEM	ablaktowanie
ABLAKTOWANIEM	ablaktować
ABLAKTOWANIOM	ablaktowanie
ABLAKTOWANIOM	ablaktować
ABLAKTOWANIU	ablaktowanie
ABLAKTOWANIU	ablaktować
ABLAKTOWANO	ablaktować
ABLAKTOWANY	ablaktować
ABLAKTOWANYCH	ablaktować
ABLAKTOWANYM	ablaktować
ABLAKTOWANYMI	ablaktować
ABLAKTOWANĄ	ablaktować
ABLAKTOWAŁ	ablaktować
ABLAKTOWAŁA	ablaktować
ABLAKTOWAŁABY	ablaktować
ABLAKTOWAŁABYM	ablaktować
ABLAKTOWAŁABYŚ	ablaktować
ABLAKTOWAŁAM	ablaktować
ABLAKTOWAŁAŚ	ablaktować
ABLAKTOWAŁBY	ablaktować
ABLAKTOWAŁBYM	ablaktować
ABLAKTOWAŁBYŚ	ablaktować
ABLAKTOWAŁEM	ablaktować
ABLAKTOWAŁEŚ	ablaktować
ABLAKTOWAŁO	ablaktować
ABLAKTOWAŁOBY	ablaktować
ABLAKTOWAŁOBYM	ablaktować
ABLAKTOWAŁOBYŚ	ablaktować
ABLAKTOWAŁOM	ablaktować
ABLAKTOWAŁOŚ	ablaktować
ABLAKTOWAŁY	ablaktować
ABLAKTOWAŁYBY	ablaktować
ABLAKTOWAŁYŚCIE	ablaktować
ABLAKTOWAŁYŚMY	ablaktować
ABLAKTOWAĆ	ablaktować
ABLAKTOWAŃ	ablaktowanie
ABLAKTOWAŃ	ablaktować
ABLAKTUJ	ablaktować
ABLAKTUJCIE	ablaktować
ABLAKTUJCIEŻ	ablaktować
ABLAKTUJE	ablaktować
ABLAKTUJECIE	ablaktować
ABLAKTUJEMY	ablaktować
ABLAKTUJESZ	ablaktować
ABLAKTUJMY	ablaktować
ABLAKTUJMYŻ	ablaktować
ABLAKTUJĄ	ablaktować
ABLAKTUJĄC	ablaktować
ABLAKTUJĄCA	ablaktować
ABLAKTUJĄCE	ablaktować
ABLAKTUJĄCEGO	ablaktować
ABLAKTUJĄCEJ	ablaktować
ABLAKTUJĄCEMU	ablaktować
ABLAKTUJĄCY	ablaktować
ABLAKTUJĄCYCH	ablaktować
ABLAKTUJĄCYM	ablaktować
ABLAKTUJĄCYMI	ablaktować
ABLAKTUJĄCĄ	ablaktować
ABLAKTUJŻE	ablaktować
ABLAKTUJĘ	ablaktować
ABLATIWACH	ablatiwus
ABLATIWAMI	ablatiwus
ABLATIWEM	ablatiwus
ABLATIWIE	ablatiwus
ABLATIWOM	ablatiwus
ABLATIWOWI	ablatiwus
ABLATIWU	ablatiwus
ABLATIWUS	ablatiwus
ABLATIWY	ablatiwus
ABLATIWÓW	ablatiwus
ABLATYW	ablatyw
ABLATYWACH	ablatyw
ABLATYWAMI	ablatyw
ABLATYWEM	ablatyw
ABLATYWIE	ablatyw
ABLATYWNA	ablatywny
ABLATYWNE	ablatywny
ABLATYWNEGO	ablatywny
ABLATYWNEJ	ablatywny
ABLATYWNEMU	ablatywny
ABLATYWNI	ablatywny
ABLATYWNY	ablatywny
ABLATYWNYCH	ablatywny
ABLATYWNYM	ablatywny
ABLATYWNYMI	ablatywny
ABLATYWNĄ	ablatywny
ABLATYWOM	ablatyw
ABLATYWOWI	ablatyw
ABLATYWU	ablatyw
ABLATYWY	ablatyw
ABLATYWÓW	ablatyw
ABLEGACI	ablegat
ABLEGACIE	ablegat
ABLEGAT	ablegat
ABLEGATA	ablegat
ABLEGATACH	ablegat
ABLEGATAMI	ablegat
ABLEGATEM	ablegat
ABLEGATOM	ablegat
ABLEGATOWI	ablegat
ABLEGATY	ablegat
ABLEGATÓW	ablegat
ABLEGIER	ablegier
ABLEGRA	ablegier
ABLEGRACH	ablegier
ABLEGRAMI	ablegier
ABLEGREM	ablegier
ABLEGROM	ablegier
ABLEGROWALI	ablegrować
ABLEGROWALIBY	ablegrować
ABLEGROWALIŚCIE	ablegrować
ABLEGROWALIŚMY	ablegrować
ABLEGROWANA	ablegrować
ABLEGROWANE	ablegrować
ABLEGROWANEGO	ablegrować
ABLEGROWANEJ	ablegrować
ABLEGROWANEMU	ablegrować
ABLEGROWANI	ablegrować
ABLEGROWANIA	ablegrować
ABLEGROWANIACH	ablegrować
ABLEGROWANIAMI	ablegrować
ABLEGROWANIE	ablegrować
ABLEGROWANIEM	ablegrować
ABLEGROWANIOM	ablegrować
ABLEGROWANIU	ablegrować
ABLEGROWANO	ablegrować
ABLEGROWANY	ablegrować
ABLEGROWANYCH	ablegrować
ABLEGROWANYM	ablegrować
ABLEGROWANYMI	ablegrować
ABLEGROWANĄ	ablegrować
ABLEGROWAŁ	ablegrować
ABLEGROWAŁA	ablegrować
ABLEGROWAŁABY	ablegrować
ABLEGROWAŁABYM	ablegrować
ABLEGROWAŁABYŚ	ablegrować
ABLEGROWAŁAM	ablegrować
ABLEGROWAŁAŚ	ablegrować
ABLEGROWAŁBY	ablegrować
ABLEGROWAŁBYM	ablegrować
ABLEGROWAŁBYŚ	ablegrować
ABLEGROWAŁEM	ablegrować
ABLEGROWAŁEŚ	ablegrować
ABLEGROWAŁO	ablegrować
ABLEGROWAŁOBY	ablegrować
ABLEGROWAŁOBYM	ablegrować
ABLEGROWAŁOBYŚ	ablegrować
ABLEGROWAŁOM	ablegrować
ABLEGROWAŁOŚ	ablegrować
ABLEGROWAŁY	ablegrować
ABLEGROWAŁYBY	ablegrować
ABLEGROWAŁYŚCIE	ablegrować
ABLEGROWAŁYŚMY	ablegrować
ABLEGROWAĆ	ablegrować
ABLEGROWAŃ	ablegrować
ABLEGROWI	ablegier
ABLEGRUJ	ablegrować
ABLEGRUJCIE	ablegrować
ABLEGRUJCIEŻ	ablegrować
ABLEGRUJE	ablegrować
ABLEGRUJECIE	ablegrować
ABLEGRUJEMY	ablegrować
ABLEGRUJESZ	ablegrować
ABLEGRUJMY	ablegrować
ABLEGRUJMYŻ	ablegrować
ABLEGRUJĄ	ablegrować
ABLEGRUJĄC	ablegrować
ABLEGRUJĄCA	ablegrować
ABLEGRUJĄCE	ablegrować
ABLEGRUJĄCEGO	ablegrować
ABLEGRUJĄCEJ	ablegrować
ABLEGRUJĄCEMU	ablegrować
ABLEGRUJĄCY	ablegrować
ABLEGRUJĄCYCH	ablegrować
ABLEGRUJĄCYM	ablegrować
ABLEGRUJĄCYMI	ablegrować
ABLEGRUJĄCĄ	ablegrować
ABLEGRUJŻE	ablegrować
ABLEGRUJĘ	ablegrować
ABLEGRY	ablegier
ABLEGRZE	ablegier
ABLEGRÓW	ablegier
ABLUCJA	ablucja
ABLUCJACH	ablucja
ABLUCJAMI	ablucja
ABLUCJE	ablucja
ABLUCJI	ablucja
ABLUCJO	ablucja
ABLUCJOM	ablucja
ABLUCJĄ	ablucja
ABLUCJĘ	ablucja
ABLUCYJ	ablucja
ABLUTOMANIA	ablutomania
ABLUTOMANIACH	ablutomania
ABLUTOMANIAMI	ablutomania
ABLUTOMANIE	ablutomania
ABLUTOMANII	ablutomania
ABLUTOMANIJ	ablutomania
ABLUTOMANIO	ablutomania
ABLUTOMANIOM	ablutomania
ABLUTOMANIĄ	ablutomania
ABLUTOMANIĘ	ablutomania
ABNEGACCY	abnegacki
ABNEGACI	abnegat
ABNEGACIE	abnegat
ABNEGACJA	abnegacja
ABNEGACJACH	abnegacja
ABNEGACJAMI	abnegacja
ABNEGACJE	abnegacja
ABNEGACJI	abnegacja
ABNEGACJO	abnegacja
ABNEGACJOM	abnegacja
ABNEGACJĄ	abnegacja
ABNEGACJĘ	abnegacja
ABNEGACKA	abnegacki
ABNEGACKI	abnegacki
ABNEGACKICH	abnegacki
ABNEGACKIE	abnegacki
ABNEGACKIEGO	abnegacki
ABNEGACKIEJ	abnegacki
ABNEGACKIEMU	abnegacki
ABNEGACKIM	abnegacki
ABNEGACKIMI	abnegacki
ABNEGACKO	abnegacko
ABNEGACKU	abnegacki
ABNEGACKĄ	abnegacki
ABNEGACYJ	abnegacja
ABNEGAT	abnegat
ABNEGATA	abnegat
ABNEGATACH	abnegat
ABNEGATAMI	abnegat
ABNEGATCE	abnegatka
ABNEGATEK	abnegatka
ABNEGATEM	abnegat
ABNEGATKA	abnegatka
ABNEGATKACH	abnegatka
ABNEGATKAMI	abnegatka
ABNEGATKI	abnegatka
ABNEGATKO	abnegatka
ABNEGATKOM	abnegatka
ABNEGATKĄ	abnegatka
ABNEGATKĘ	abnegatka
ABNEGATOM	abnegat
ABNEGATOWI	abnegat
ABNEGATY	abnegat
ABNEGATÓW	abnegat
ABO	abo (ndm)
ABOLICJA	abolicja
ABOLICJACH	abolicja
ABOLICJAMI	abolicja
ABOLICJE	abolicja
ABOLICJI	abolicja
ABOLICJO	abolicja
ABOLICJOM	abolicja
ABOLICJONISTA	abolicjonista
ABOLICJONISTACH	abolicjonista
ABOLICJONISTAMI	abolicjonista
ABOLICJONISTCE	abolicjonistka
ABOLICJONISTEK	abolicjonistka
ABOLICJONISTKA	abolicjonistka
ABOLICJONISTKI	abolicjonistka
ABOLICJONISTKO	abolicjonistka
ABOLICJONISTKOM	abolicjonistka
ABOLICJONISTKĄ	abolicjonistka
ABOLICJONISTKĘ	abolicjonistka
ABOLICJONISTO	abolicjonista
ABOLICJONISTOM	abolicjonista
ABOLICJONISTY	abolicjonista
ABOLICJONISTĄ	abolicjonista
ABOLICJONISTĘ	abolicjonista
ABOLICJONISTÓW	abolicjonista
ABOLICJONIZM	abolicjonizm
ABOLICJONIZMACH	abolicjonizm
ABOLICJONIZMAMI	abolicjonizm
ABOLICJONIZMEM	abolicjonizm
ABOLICJONIZMIE	abolicjonizm
ABOLICJONIZMOM	abolicjonizm
ABOLICJONIZMOWI	abolicjonizm
ABOLICJONIZMU	abolicjonizm
ABOLICJONIZMY	abolicjonizm
ABOLICJONIZMÓW	abolicjonizm
ABOLICJONIŚCI	abolicjonista
ABOLICJONIŚCIE	abolicjonista
ABOLICJĄ	abolicja
ABOLICJĘ	abolicja
ABOLICYJ	abolicja
ABOLICYJNA	abolicyjny
ABOLICYJNE	abolicyjny
ABOLICYJNEGO	abolicyjny
ABOLICYJNEJ	abolicyjny
ABOLICYJNEMU	abolicyjny
ABOLICYJNI	abolicyjny
ABOLICYJNY	abolicyjny
ABOLICYJNYCH	abolicyjny
ABOLICYJNYM	abolicyjny
ABOLICYJNYMI	abolicyjny
ABOLICYJNĄ	abolicyjny
ABOMINACJA	abominacja
ABOMINACJACH	abominacja
ABOMINACJAMI	abominacja
ABOMINACJE	abominacja
ABOMINACJI	abominacja
ABOMINACJO	abominacja
ABOMINACJOM	abominacja
ABOMINACJĄ	abominacja
ABOMINACJĘ	abominacja
ABOMINACYJ	abominacja
ABONAMENCIE	abonament
ABONAMENT	abonament
ABONAMENTACH	abonament
ABONAMENTAMI	abonament
ABONAMENTEM	abonament
ABONAMENTOM	abonament
ABONAMENTOWA	abonamentowy
ABONAMENTOWE	abonamentowy
ABONAMENTOWEGO	abonamentowy
ABONAMENTOWEJ	abonamentowy
ABONAMENTOWEMU	abonamentowy
ABONAMENTOWI	abonament
ABONAMENTOWI	abonamentowy
ABONAMENTOWY	abonamentowy
ABONAMENTOWYCH	abonamentowy
ABONAMENTOWYM	abonamentowy
ABONAMENTOWYMI	abonamentowy
ABONAMENTOWĄ	abonamentowy
ABONAMENTU	abonament
ABONAMENTY	abonament
ABONAMENTÓW	abonament
ABONENCCY	abonencki
ABONENCI	abonent
ABONENCIE	abonent
ABONENCKA	abonencki
ABONENCKI	abonencki
ABONENCKICH	abonencki
ABONENCKIE	abonencki
ABONENCKIEGO	abonencki
ABONENCKIEJ	abonencki
ABONENCKIEMU	abonencki
ABONENCKIM	abonencki
ABONENCKIMI	abonencki
ABONENCKO	abonencko
ABONENCKU	abonencki
ABONENCKĄ	abonencki
ABONENT	abonent
ABONENTA	abonent
ABONENTACH	abonent
ABONENTAMI	abonent
ABONENTCE	abonentka
ABONENTEK	abonentka
ABONENTEM	abonent
ABONENTKA	abonentka
ABONENTKACH	abonentka
ABONENTKAMI	abonentka
ABONENTKI	abonentka
ABONENTKO	abonentka
ABONENTKOM	abonentka
ABONENTKĄ	abonentka
ABONENTKĘ	abonentka
ABONENTOM	abonent
ABONENTOWI	abonent
ABONENTY	abonent
ABONENTÓW	abonent
ABONOWALI	abonować
ABONOWALIBY	abonować
ABONOWALIBYŚCIE	abonować
ABONOWALIBYŚMY	abonować
ABONOWALIŚCIE	abonować
ABONOWALIŚMY	abonować
ABONOWANA	abonować
ABONOWANE	abonować
ABONOWANEGO	abonować
ABONOWANEJ	abonować
ABONOWANEMU	abonować
ABONOWANI	abonować
ABONOWANIA	abonowanie
ABONOWANIA	abonować
ABONOWANIACH	abonowanie
ABONOWANIACH	abonować
ABONOWANIAMI	abonowanie
ABONOWANIAMI	abonować
ABONOWANIE	abonowanie
ABONOWANIE	abonować
ABONOWANIEM	abonowanie
ABONOWANIEM	abonować
ABONOWANIOM	abonowanie
ABONOWANIOM	abonować
ABONOWANIU	abonowanie
ABONOWANIU	abonować
ABONOWANO	abonować
ABONOWANY	abonować
ABONOWANYCH	abonować
ABONOWANYM	abonować
ABONOWANYMI	abonować
ABONOWANĄ	abonować
ABONOWAŁ	abonować
ABONOWAŁA	abonować
ABONOWAŁABY	abonować
ABONOWAŁABYM	abonować
ABONOWAŁABYŚ	abonować
ABONOWAŁAM	abonować
ABONOWAŁAŚ	abonować
ABONOWAŁBY	abonować
ABONOWAŁBYM	abonować
ABONOWAŁBYŚ	abonować
ABONOWAŁEM	abonować
ABONOWAŁEŚ	abonować
ABONOWAŁO	abonować
ABONOWAŁOBY	abonować
ABONOWAŁOBYM	abonować
ABONOWAŁOBYŚ	abonować
ABONOWAŁOM	abonować
ABONOWAŁOŚ	abonować
ABONOWAŁY	abonować
ABONOWAŁYBY	abonować
ABONOWAŁYBYŚCIE	abonować
ABONOWAŁYBYŚMY	abonować
ABONOWAŁYŚCIE	abonować
ABONOWAŁYŚMY	abonować
ABONOWAĆ	abonować
ABONOWAŃ	abonowanie
ABONOWAŃ	abonować
ABONUJ	abonować
ABONUJCIE	abonować
ABONUJCIEŻ	abonować
ABONUJE	abonować
ABONUJECIE	abonować
ABONUJEMY	abonować
ABONUJESZ	abonować
ABONUJMY	abonować
ABONUJMYŻ	abonować
ABONUJĄ	abonować
ABONUJĄC	abonować
ABONUJĄCA	abonować
ABONUJĄCE	abonować
ABONUJĄCEGO	abonować
ABONUJĄCEJ	abonować
ABONUJĄCEMU	abonować
ABONUJĄCY	abonować
ABONUJĄCYCH	abonować
ABONUJĄCYM	abonować
ABONUJĄCYMI	abonować
ABONUJĄCĄ	abonować
ABONUJŻE	abonować
ABONUJĘ	abonować
ABORCIE	abort
ABORCIE	abortus
ABORCJA	aborcja
ABORCJACH	aborcja
ABORCJAMI	aborcja
ABORCJE	aborcja
ABORCJI	aborcja
ABORCJO	aborcja
ABORCJOM	aborcja
ABORCJONISTA	aborcjonista